11111111111111111111111111111111
10000000000000000000000000000001
11111111111111111111111111111111
11111111111111111111111111111111
11111111111111101111111111111111
11111111111111101011111111111111
11111000000000000P0000000C111111
11111011111111111011111111111111
11111011111111111011111111111111
11111011111111111011111111111111
11111011111111111C11111111111111
11111011111111111011111111111111
11111011111111111111111111111111
11111011111111111011111111111111
11111000000000000E11111111111111
11111111111111111111111111111111
11111111111111111111111111111111
11111111111111111111111111111111
11111111111111111111111111111111
11111111111111111111111111111111
11111111111111111111111111111111
10000000000000000000000000000001
11111111111111111111111111111111