11111111111111111111111111111111
100000000000000P0000000000000001
10111111111111101111111111111101
10111111111111111111111111111101
10111111111111101000000000001101
10111111111111101111111111101101
101111C000000000000000001C101101
101111C100000000000000001C101101
101111C100000000000000001C101101
101111C1000000000001E0001C101101
11100001000000000000000010000001
11011101000000000000000010111011
11011101111111111111111110111011
11011100000000010000000000111011
11011111110100100111111111111011
11000011110111111111111111111011
11011011110111111111111111111011
11011011110111111111111111111011
11011000000111111111111111111011
11011111111111111111111111111011
11011111111111111111111111111011
11000000000000000000000000000011
11111111111111111111111111111111