11111111111111111111111111111111
1000000000000000E000010000000001
11111111000111110111110011111101
10001110110011110111100101111101
10101101111001110111001110111101
10101010000101110110011111011101
10100000110000110100111111101101
10101111111111010001111111110101
1001111111111110C111111111111001
10000000110000C111C0000110000001
1001101111110110C101111111111001
10101000110001010100000110000001
10110110000110110110110000111001
10111011111101110111011111110101
10111101111011110111101111101101
10111110110111110111110111011101
10111111001111110111111010111101
10111111001111110111111101111101
1000000000000000P000000000000001
11111111111111111111111111111111