11111111111111111111111111111111
11000100000000000000000000000001
11011101111111110111111111111101
1000000000000000000011011P000001
11011101110111110110110000111101
11010100000000010110110110111101
11010101110111110110110110000001
100101000000CC010110110110101101
11010101110111110110110000101101
11110111111111111110000110110001
10C000000000000000C0110110001101
10111111111111111110110110110001
10100000000000000000110110111101
1011011110111111101011C110110001
10100000001000110010110110111101
1011011110111000101011C111110001
10110111101010101110110110101111
1010000010101010001011C110101101
1011010110101011101011011E000001
10110100000010111011111000111111
10111111111110111000011011111101
10000000000000111111000000000001
11111111111111111111111111111111