11111111111111111111111111111111
10000110111000000100011110000101
10110100000011110001000000110001
11110111011111011111011111111101
10000000000000010000000000000011
11011110101011111111111110111011
10000110101000000000000100111011
11110110101011111111111111111011
100000000000000C1000000000001001
100000000110000C1011111111111101
100P00011110000C101000100000E101
100000011110000C1010100000000101
100000000010000C1010111111111101
100000000010000C0010000000000001
11011010111111111111111111111011
10000110100000000000000000000011
11110000101111110111001011001011
10100111111101111101011011011011
10101000000001000000000000000001
10001101111101111111110111010101
10101000100000000110000101011101
10000011111101110001010001000111
11111111111111111111111111111111