11111111111111111111111111111111
1P000000000000000000000000000001
10110101111011011011011110101101
10110111110101C00C10101111101101
10000000001111100111110000000001
10110101100000100100000111110101
1001010000111101101111011C100101
10100011100010111101000100001101
10101000101100000000110111101001
10111001101011111111010100001101
101000101001001C0100100001110001
101010110C111110011111C110101101
10000000010000000000001000000001
10111011101111100111111011011101
10000101000000010000000010100001
10101010101111100111110101010101
10110101101000100100C10110101101
10101010101010000001010101010101
11010110101010101101010101101011
10100010100000100100000001010101
11011000111110111101111100010011
1C0000100000000010000000010000E1
11111111111111111111111111111111