11111111111111111111111111111111
1P00000010CCCCCCCCCCCCCCC0000101
10101110101111111111111110110001
10000010100010000010010010010001
10101110101110111010110001000111
10111000111000001000000111110101
11000011101010111111110001010001
110110000001101C1001110111010101
11011101110110100010000100010101
10000001010000110110111011000001
10111111110110100110010000011101
10000001000010110001011101000101
11011011110111110101000101010111
100010001C1100100101011011010101
11010111101101110111000000010001
10010110000001000001011111111101
11100001111011110111001000010001
10001100000000000000011011010111
1010111111111111101111111000C111
10100000000100001100000011110001
10111111010110111101101010110101
1000011001000000110100100000E101
10111000110111100001010111011001
11111111111111111111111111111111