11111111111111111111111111111111
10011000111010001100000000110001
11000110000000100010101110100111
11011000101101101010100010001001
10010101000100011110101111100011
11000001101111001000011001011011
11011000010000010011000011000011
11010010110111111010011110111001
10001010C1CCCCCCCC1C100010001011
11101110111111111110011011101011
1000001010000000P001000000100011
10111011101110110101111010110111
10101000100010011100101110010001
110000110110111C0C11100000111011
1101110100101010E000010111010101
100001000100101C0C11010000000101
11110111011001011010000101111001
10010010001100100011101001010011
11011011101110111010100100010001
10000000101000101010011010101011
10111010101011000011000010100001
10010010000010011000010100001011
11111111111111111111111111111111